11223344111231423143
00000000000000001111113300
00000000000000001111113300
00220000000000001100001100
00220000000000001100001100
22332200000022222222001100
22332200000022222222001100
00223322000022003322111100
00223322000022003322111100
00002200331122330022000000
00002200331122330022000000
00000000110022112222000000
00000000110022112222000000
00002222112200110000000000
00002222112200110000000000
00002200332211330000000000
00002200332211330000000000
11111133002200002222000000
11111133002200002222000000
11002222222200002211110000
11002222222200002211110000
11000011000000000011222200
11000011000000000011222200
33111111000000000000221111
33111111000222200000221111
00000000000200200000001111
00000000000200200000001111
