1
00000000000000000000000000
00000000000000000000000000
00000000000000000000000000
00111111111111111111100000
00000000000000000100000000
00000000000000000100000000
11111111111111000100000000
00000000000000000100000000
00000000000000000100000000
00111111111111111100000000
00000000000000000100000000
00000000000000000100000000
11111111111111000100000000
00000000000000000100000000
00000000000000000100000000
00000000000000000100000000
00000000000000000100000000
00011111111111111100000000
00000000010000000100000000
00000000010000000100000000
00000000010000000100000000
11111110010000000100000000
00000000010000000100000000
00000000011111111100000000
00000000000000000100000000
00000000000000000100000000
