11223344111231423143
00000000000000000000000000
00000000000000000000000000
00000000000000000000000000
00000003333333333000000000
00000003000003333000000000
00000003333333333000000000
00000030000000000000000000
00000035555555555000000000
00000035555555555000000000
00000030000000000000000000
00000030000000000000000000
33333333333333331000000000
30000033333000030000000000
33333333333000030000000000
00000033333333333333000000
00000003333333333333000000
00000003333333333333000000
00000033303333333333000000
00000033333333333333000000
00000000000000000000000000
00000000000000000000000000
00000000000000000000000000
00000000000000000000000000
00000000000111100000000000
00000000000100100000000000
00000000000100100000000000
