11223344111231423143
00000000222200002200000000
00000000222200002200000000
00333322220000002200000000
00333322220000002200000000
33333333333333332222000000
33333333333333332222000000
33112233222222333333332211
33002233222222333333332211
33332233333311333322102200
33332233333300333322102200
00333322003333333322002200
00333322113333333322002200
00222222222233332222203333
00222222222233332222203333
01112222000000222200000033
01002222000000220000000033
00220022000000223333222033
00220022001122003333222033
00220000022222333322000033
00220000022200333322000033
00222220022233330033223333
00222220020033332233223333
00002200330000002233223300
00002200330222202233003300
00002200330200200033333300
00000000330200200033333300
