11223344111231423143
26
26
00000000000000000000000000
00000000000000000000000000
00001133110000000000000000
00001133110000000000000000
00000033003300000000000000
00000033003311000000000000
00330000000033000000000000
00330000000033220000000000
00333300003300330000000000
00333300003300331100000000
00330033003300003300000000
00330033003300003322000000
00330000330000003333000000
00330000330000003333110000
00003300000000333333330000
00003300000000333333332200
00000033000033003333333300
00000033000033003333333300
22000000000033000033333311
22000000000033000033333311
22220000000000330033333333
22220000000000330033333333
11222200000000003300333333
11222200000222203300333333
11112222000200203300003333
11112222000200203300003333
