11223344111231423143
00000000000000000000000000
00000000220000002200000000
00222222220000002222222200
00222222220000002222222200
00220000000022000000001100
00220000000022000000001100
00110022220000002222002222
00110022000000000022002222
00220020330011003302001122
00220020331111113302001122
00220000333333333300001122
00000000333333333300000022
22000000333333333300000022
22110000333333333300002222
22110020331111113302002200
22110020330011003302002200
22220022000000000022001100
22220022220000002222001100
22110000000022000000002200
22110000000022000000002200
22222222220000002222221111
22222222220000002222221111
22220000220000002200002200
22220000000222200000002200
22220000000200200000000000
22220000000200200000000000