11223344111231423143
00000000000200203333000000
00000000000200203333000000
00200100200000000233200233
00200100200000000233200233
00200100200022000233200233
00200100200022000233200233
00220000220011002233002233
00220000220011002233002233
00000002110022002210003333
00000002000022000010003333
22222000003322330000022222
22222000003322330000022222
00000000023333332000000000
00000000023333332000000000
11222200223333332202222211
11222200003333330002222211
11111100000033000000111111
00000000220033002200000000
00220000220000002200000000
00220000220000002200000000
00222000002200220000022233
00222000000000000000022233
00002200000000000000333333
00000000000222200000333333
00000000000200200000003333
00002200000200200000223333