11223344111231423143
00000000000000000000000000
00000000000000000000000000
00111111111111111100000000
00000000000000000100000000
00000000000000000100000000
11111111111111100100000000
00000000000000000100000000
00000000000000000100000000
00111111111111111100000000
00100000100000100100000000
00100000100000100100000000
00100100100100100100000000
00100100100100100100000000
00000100000100000100000000
00000100000100000100000000
11111111111111100100000000
00000000000000100100000000
00000000000000100100000000
00000000000000100100000000
00000000000000100100000000
00111111111111100100000000
00000000000000000100000000
00000000000000000100000000
00111111111111111100000000
00000000000000000100000000
00000000000000000100000000
