11223344111231423143
10000000000000000000000000
10000000000000000000000000
10000000000000000000000000
10000000000000000000000000
10000000000000000000000000
10000005555000003333330000
00000005000000000000030000
00000005000000000000030000
00000005000000000000030000
00000000000000000000030000
00000000000222222200030000
00000000000200000200030000
00000000000200000200030000
00000000000200000200000000
00000000000200000220000000
00000000000222000000000000
00000000000000000000000000
00000000000000000000000000
00000001111111111111111000
00000001000000000000001000
00000001000000000000001000
00000001000000000000001000
00000001000000000000001000
00000001000000000000001000
00011111000000000010001000
00000000000000000011111000
