11111111112222111144
00000000220000002200000000
00000000220000002200000000
00333333220000000000000000
00333333220000000000111111
22333333000000000000000000
22333333000000000000000000
33333333000000220022222220
33333333000000220022222220
33333333222222220022000200
33333333222222000022000200
33333333000022000000000200
33333333000022000000000200
00330000000011111100003300
00330000000011111100003300
00000000000000000033333333
00220022000000000033333333
22200222200222222233333333
22200222200200000033333333
00000000002200000033333333
00000000002200222233333333
22000010000000222233333300
22000010000000000033333300
22220010000000000033333300
22220010000222200033333300
11222200000200200022000000
11222200000200200022000000