11223344111231423143
26
26
00000000000000111100000000
00000000000000000000000000
00001111111100000000110000
00001100000000000000110000
00001100000033001111110000
00001100000033000011110000
00110000003311000000110000
00110000003311000000110000
00000000331111000000111100
00000000331111000000001100
00110033111111001100000000
00110033111111001100000000
00010011110000001111000000
00010011110000001111000000
10000000110011111100000100
10000000110011111100000100
00011100000011113300001100
00011100000011113300001100
00110000000011330000111100
00110000000011330000111100
00111111000033000011000000
00000011000033000011000000
00000000000000000011000011
00000000000222200000001111
00000000000200200000000000
11110000000200200000000000