11111111112222111144
26
26
00000000222200000000000000
00000000222200000000000000
00002200220000001111110000
11002200220000000000110000
11002200000022000000000000
11002200000022000000000000
22002222220022220055550055
22002222220022220055550055
22000000220000000055000000
00000000000000000055000000
00000000555500555555002222
00002200555500555555002222
22220000552200222000000000
22220000552200222000000000
00000000550000000000011000
00000000550000000000011000
55555500550011002200010000
55555500550011002200010000
00000000000000000000012222
00000022220000000000012222
00000000222222222200000000
00000000220000002222000000
22222200000000000022220000
22220000000222200000220000
22000000000200200000000000
00000000000200200000000000