11223344111231423143
00000000000000000000000000
00000000220000000000220000
00220022220000444444222200
00220022220000444444222200
00220000220011444444444400
00220000220011444444444400
44444410220000224444444400
44444410220000224444444400
44444444444422220220000000
44444444444422220220000000
00000144444444220220001111
00000144444444220220000000
22222222444444444444442222
22222222444444444444442222
00000022224444444410000000
00000022224444444410000000
00222222004444442222002200
00222222004444442222002200
44444422440000000022002200
44444422440000000022002200
44444444441100110000002200
44444444440000000000222200
22444444440000000022000000
22444444440222200022000000
22221000000200200022002200
22221000000200200022002200
