11111111112222111144
00333300000000000000003300
00333300000000000000003300
33330000002222000000000033
33330000222222222200000033
33000002222222222222000011
33000002222222222222220000
11000022222222222222222000
00000022222222222222222000
00000222000000222222002000
00000200000000002222002000
55000200100010002220000000
55000200100010002220000000
00002200000000002220005555
00002200222200002220005555
00002222222222222222000000
00002222222222222222000000
00022222222222222222200000
00022222222222222222200000
00222222222222222222220000
00000022222222222200000000
00222200222222220022220033
00222222002222002222220033
33002222000000002222003333
33000000000222200000003333
11330000000200200000333311
11330000000200200000333311