11223344111231423143
26
26
00000000001100220022220000
00000000001100220022220000
00022222222200220000000000
00022222222200220000000000
00000020002200222200333333
00000020002200222200333333
00020000000000110033333333
00020000000000110033333333
00020022222211222233332211
00020022222211222233330011
00222222110000220033330002
00000000110000220033330002
02222222001133333333330000
02222222001133333333330000
00000011000033333333332200
00000011000033333333332200
11220033333333113333332200
11220033333333113333332200
02223333333333000000002220
02223333333333000000002220
00223333000000001122222200
00223333000000000022222200
00003333000000000022000200
00003333000222200022000200
00003333000200200000000000
00223333000200200000000000