11223344111231423143
00000022000000000000330000
00000022000000000011330000
22000000000000330111100022
22000000000011330111100022
00000000330111100011330000
00000011330111100000330000
00000111100011330000000000
00000111100000330000000000
00000011330000000000000000
00000000330000000000000000
00000033003300330033000000
00000033113300331133000000
11220001111000011110002211
11220001111000011110002211
00000033113300331133000000
00000033003300330033000000
00000000000000000000000000
00000000110000001100000000
22000001111000011110000022
22000001111000011110000022
22000033113300331133000022
22000033003300330033000022
00000000000000000000000000
00002200000222200000220000
00002222000200200022220000
00002222000200200022220000
