44443344111231423143
00000000000000000000000000
00000000000000000000000000
00220022002200220022002200
00220022002200220022002200
00220022002200220022002200
00220022002200220022002200
00220022002211220022002200
00220022002211220022002200
00220022002200220022002200
00220022000000000022002200
00220022000000000022002200
00000000002200220000000000
00000000002200220000000000
22002222000000000022220022
11002222000000000022220011
00000000002200220000000000
00000000002222220000000000
00220022002222220022002200
00220022002200220022002200
00220022002200220022002200
00220022002200220022002200
00220022000000000022002200
00220022000000000022002200
00220022000222200022002200
00000000000200200000000000
00000000000200200000000000