11223344111231423143
26
26
00000000000000222222000000
00000000000000222222000000
00222222000000000022000000
00222222220022000022000000
00000000220022000000002222
00000000220000000000002222
00555555555500222000002211
00555555555500222000002200
00000000005500220011102200
00001111115500220011102200
22002222225555550055222200
22002222225555550055222200
00000000115500000055110000
00000000115500000055000000
55555500555522220055000000
55555500555522220055000000
00000000002211110055555500
00000000002200000055555500
22222200000000000000000000
22222200000000000000000000
00002200111100000022220002
00002200000000000022220002
22000000000000000022000022
22000000000222200022000022
00000000000200200000000000
00000000000200200000000000
