11111111112222111144
00000011000000110000000000
00000011000000110000000000
00220011000000220022002200
00220011000000220022002200
00220000000022220022112200
00220000000022220022112200
00000022000000000011000000
00000022000000000011000000
33000022000011000022332200
33000022000011000022332200
33330000002200001100330000
33330000002200001100330000
00222222333333110000332200
00222222333333110000332200
00000011332200220022002200
00000011332200220022002200
11220011002200220000002200
11220011002200220000002200
00220022002222220022112200
00220022002222220022112200
00220022002222220000000000
00220022002222220000000000
00220000000000000022002200
00220000000222200022002200
00220022000200200022222200
00220022000200200022222200