11223344111231423143
00000000000000000000000000
00000000000000000000000000
33330000002222220000003333
33330000222222222200003333
33000002222222222220000033
33000002222222222220000033
00000022223322332222000000
00000022223322332222000000
00000022333322333322000000
00000022333322333322000000
33000022222222222222000033
33000022222222222222000033
33330000223322332200003333
33330000223322332200003333
55555500222222222200555555
55555500222222222200555555
00000000020202020200000000
00000000020202020200000000
00000000202020202000000000
00000000202020202000000000
01010100000000000000101010
01010100000000000000101010
20202000000000000000020202
20202000000222200000020202
10101001000200200010010101
10101001000200200010010101
