12341122334121234132
00002200002200000022000000
00002200002200220022000000
33222222002200000022200000
33222222002200000022200000
33333300002200220022000220
33333300000000220000000220
33555555555555555555550055
33555555555555555555550055
00220000000000000000000000
00220000000022220000000000
00002200000222222222221111
00002200000222220022000000
22220022000222223322000022
22220022000222223322111122
00000011000000333333330000
00000011001100333333330000
55550055555555550055555555
55550055555555550055555555
33330002000000000000000000
33330002000022220000000000
33332200200000020000002200
33332200200000020011222200
33002200200000000022002200
33112200200222200000002200
00000000000200200000002200
00000000000200200022000000